UTFT	KEYWORD1
UTouch	KEYWORD1
Caveatron_GUI	KEYWORD1

print KEYWORD2
printNumI KEYWORD2
printNumF KEYWORD2

InitGUI KEYWORD2
addButton	KEYWORD2
addIconButton	KEYWORD2
addHiddenButton	KEYWORD2
addToggleSwitch	KEYWORD2
addTextInputBox	KEYWORD2
addPanel	KEYWORD2
addProgressBar	KEYWORD2
showImage	KEYWORD2

preserveColors	KEYWORD2
restoreColors	KEYWORD2
updatingScreen	KEYWORD2
finishedUpdatingScreen	KEYWORD2
startTimer	KEYWORD2
stopTimer	KEYWORD2
restartTimer	KEYWORD2
clearAllObjects	KEYWORD2
redrawAllObjects	KEYWORD2
addcharTextInputBox	KEYWORD2
delcharTextInputBox	KEYWORD2
clearTextInputBox	KEYWORD2
toggleButton	KEYWORD2
updateProgressBar	KEYWORD2


LEFT_J	LITERAL1
RIGHT_J	LITERAL1
CENTER_J	LITERAL1

BLACK_STD	LITERAL1
WHITE_STD	LITERAL1
RED_STD	LITERAL1
RED_DRK	LITERAL1
RED_BLK	LITERAL1
RED_GRY	LITERAL1
GREEN_STD	LITERAL1
GREEN_DRK	LITERAL1
BLUE_STD	LITERAL1
YELLOW_STD	LITERAL1
BUTTON_STD	LITERAL1
BUTTON_LGT	LITERAL1
BAR_TOP	LITERAL1
GRAY_025	LITERAL1
GRAY_050	LITERAL1
GRAY_075	LITERAL1
BLUE_SEL	LITERAL1
BLUE_BAR	LITERAL1
GREEN_BAR	LITERAL1
TAN_BAR	LITERAL1
GREEN_BAR	LITERAL1
GREEN_BAR	LITERAL1
TAN_LGT	LITERAL1
TAN_STD	LITERAL1
TAN_DRK	LITERAL1

OnPress LITERAL1
OnRelease LITERAL1

